4 1
3 0 0 8 0 0
b b 0 b b b
0 0 0 l 2 0
0 0 0 0 0 0
0 0 0 1 0 0