2 0
0 0 0 0 0 0
0 l 3 0 0 0
0 0 0 0 0 0
0 0 0 0 0 0
0 0 1 0 0 0