5 2
0 0 0 0 0 0
0 2 3 l 4 0
0 0 L 6 0 0
0 0 0 0 0 0
0 7 4 0 0 1