3 2
0 l 0 4 b 2
0 0 0 0 b 0
1 0 0 0 b l
0 0 0 0 b 0
0 0 0 0 b 2